#
#
#
#


0,0,1,0,0,0
0,q,p,w,0,0
1,1,1,1,1,0
1,1,1,s,0,0
1,@,s,0,0,0
